门急诊总费用 = 门急诊收入;
住院总收入 = 住院总费用 - 住院伙食费;
医疗总收入 = 医疗总费用 = 门急诊总费用 + 住院总费用 - 住院伙食费;
出院人次 = 出院人数;
门急诊均次费变动的影响 = 门急诊收入同比增幅 - 门急诊人次变动的影响;
医疗总收入增幅 = (医疗收入增长额)/ (去年本期时间段的医疗总收入) =（本期医疗总收入-去年本期时间段的医疗总收入）/（去年本期时间段的医疗总收入);
门急诊收入同比增幅 （本期门急诊收入 - 去年本期门急诊收入）/ 去年本期门急诊收入;
门急诊收入增幅 =（本期门急诊总收入-去年本期时间段的门急诊总收入）/（去年本期时间段的门急诊总收入);
住院收入增幅 = (本期住院总收入-去年本期时间段的住院总收入）/（去年本期时间段的住院总收入;
门急诊人次变动的影响 = (本期门急诊人数-上期门急诊人数)/上期门急诊人数;
门急诊均次费变动的影响 = 门急诊同比增幅 - 门急诊人次变动的影响;
门急诊医疗服务收入占比 = 门急诊医疗服务费 / 门急诊总费用;
门急诊检查化验收入占比 = (门急诊检查费 + 门急诊检验费) / 占门急诊总费用;
门急诊卫生材料收入占比 = 门急诊耗材费 / 门急诊总费用;
门急诊药品收入占比 = 门急诊药费 / 门急诊总费用;
门急诊医疗服务收入占比变动 = （本期医疗服务占比- 上期医疗服务占比）;
门急诊检查化验收入占比变动 = （本期检查化验收入占比- 上期检查化验收入占比）;
门急诊卫生材料收入占比变动 = （本期卫生材料收入占比- 上期卫生材料收入占比）;
门急诊药品收入占比变动 = （本期药品收入占比- 上期药品收入占比）;
住院医疗服务收入占比 = 住院医疗服务费/医疗总费用的比例;
住院检查化验收入占比 = (住院检验费 + 住院检查费) / 医疗总费用;
住院卫生材料收入占比 = 住院耗材费/医疗总费用;
住院药品收入占比 = 住院住药费/医疗总费用;
住院检查化验费 = 住院检验费 + 住院检查费;
住院卫生材料 = 住院耗材;
住院药品收入 = 住院药费;
住院医疗服务收入占比变动 = （本期医疗服务占比- 上期医疗服务占比）;
住院检查化验收入占比变动 = (本期检查化验收入占比- 上期检查化验收入占比);
住院卫生材料收入占比变动 = （本期卫生材料收入占比- 上期卫生材料收入占比）;
住院药品收入占比变动 = （本期药品收入占比- 上期药品收入占比）;


